<지원 택배사>

이름	코드
DHL	de.dhl
Sagawa	jp.sagawa
Kuroneko Yamato	jp.yamato
Japan Post	jp.yuubin
천일택배	kr.chunilps

CJ대한통운	kr.cjlogistics
CU 편의점택배	kr.cupost
GS Postbox 택배	kr.cvsnet
CWAY (Woori Express)	kr.cway
대신택배	kr.daesin

우체국 택배	kr.epost
한의사랑택배	kr.hanips
한진택배	kr.hanjin
합동택배	kr.hdexp
홈픽	kr.homepick

한서호남택배	kr.honamlogis
일양로지스	kr.ilyanglogis
경동택배	kr.kdexp
건영택배	kr.kunyoung
로젠택배	kr.logen

롯데택배	kr.lotte
SLX	kr.slx
성원글로벌카고	kr.swgexp
TNT	nl.tnt
EMS	un.upu.ems

Fedex	us.fedex
UPS	us.ups
USPS	us.usps
